<h1>Förklaring över i arbetet använda beteckningssätt för
utmärkelsetecken och ledamotskap.</h1>

bg — för berömliga gärningar.
G M — guldmedalj.
G V Ol M — Gustaf V:s olympiska minnesmedalj.
Hed L — hedersledamot.
Idrm g — idrottsmärke i guld.
Iqml — illis quorum meruere labores.
L Fr K A — ledamot av Akademien för de fria konsterna.
L F S — ledamot av Fysiografiska sällskapet i Lund.
L H A — ledamot av Vitterhets-, historie- och antikvitetsakademien.
L H V S — ledamot av Humanistiska vetenskapssamfundet i Uppsala.
L I V A — ledamot av Ingenjörsvetenskapsakademien.
L Kr V A — ledamot av Krigsvetenskapsakademien.
L L A — ledamot av Lantbruksakademien.
L L H S — ledamot av Humanistiska vetenskapssamfundet i Lund.
L M A — ledamot av Musikaliska akademien.
L Sk S — ledamot av Samfundet för utgivande av handskrifter rörande Skandinaviens historia.
L V A — ledamot av Vetenskapsakademien.
L V S — ledamot av Vetenskapssocieteten i Uppsala.
L V V S — ledamot av Vetenskaps- och vitterhetssamhället i Göteborg.
L Ö S — ledamot av Örlogsmannasällskapet.
mf — för medborgerlig förtjänst.
patr — Patriotiska sällskapets.
sfb — skytteförbunds.
sjv — svenska frivilliga sjukvårdsväsendets.
skdl — föreningens för skidlöpningens befrämjande.
Skdl g — skidlöparmärke i guld.
Skm g — skyttemärke i guld.
S M — silvermedalj.
Sv cfi — Sveriges centralförenings för idrottens främjande.
Sv g if rfb — Svenska gymnastik- och idrottsföreningarnas riksförbunds.
Sv l cfb — Sveriges landstormsföreningars centralförbunds.
Sv m ifb — Sveriges militära idrottsförbunds.
Sv m ifb GM m krans — Sveriges militära idrottsförbunds prismedalj i guld med krans.
Sv sfb — Sveriges skytteförbunds överstyrelses.
tf — för tapperhet i fält.
ts — för tapperhet till sjöss.
V A — Vetenskapsakademiens.
vacc — för vaccinationens befrämjande.
V G M — Vasamedalj i guld.
V S L — Vetenskapssocieteten i Lund.

