XIII

UNRRA — United Nations Relief
and Rehabilitation Administration
UN T — Upsala Nya Tidning

V

VA — Vetenskapsakademien
WCC — World Council of Churches
Vectu — Svenska
tidningsutgivareföreningens veckotidningssektion
WHO — World Health
Organiza-tion

VHS — Veterinärhögskolan
VJ — Vecko-Journalen
VM — Världsmästerskap
VS — Vetenskapssocieteten i
Uppsala

VSL — Vetenskapssocieteten i Lund
VU — verkställande utskott
VVK — Väg- och
vattenbyggnadskåren

VVS — Vetenskaps- och
vitterhetssamhället i Gbg

Y

YK — Yrkeskvinnors klubb
YSF — Yrkeskvinnors
samarbets-förbund

Ö

ÖB —■ Överbefälhavaren
ÖS — Örlogsmannasällskapet
ÖÄ — Överståthållarämbetet