SkI — Skogsinstitutet

SKIF —  Svenska  konsulterande ingenjörers förening

SKP — Sveriges kommunalanställdas pensionskassa

SkS — Samfundet för utgivande av handskrifter rörande Skandinaviens historia

SLAB — Svenska lastbil ab

SLF — Sveriges läkareförbund

SLN — Sveriges lärares nykterhetsförbund

SLR — Svenska lantmännens riksförbund

SLS — Svenska landsbygdens studieförbund

SLT — ab Sveriges litografiska tryckerier

SM — Svenskt mästerskap

SMF — Svenska missionsförbundet

SMS — Sveriges maskinindustriförenings standardiseringskommitté

SNLF — Sveriges nykterhetsvänners landsförbund

SNS —  Studieförbundet Näringsliv och Samhälle

SPF — Svenska prästförbundet

SPP — Svenska Personal-Pensionskassan

SR — Statstjänstemännens riksförbund

SSA — Svenska Sockerfabriks-ab

SSF — Svenska slöjdföreningen

ssjndn — sinnessjuknämnden

SSN — Sjuksköterskornas samarbete i Norden

SSU — Sveriges socialdemokratiska ungdomsförbund

SSUH — Sveriges studerande ungdoms  helnykterhetsförbund

ST — Stockholms-Tidningen

STAB — Svenska tändsticksaktiebolaget

STAL — Svenska turbinfabriks ab Ljungström

STC — Sveriges trävaruhandlareföreningars centralförbund

STF — Svenska turistföreningen

StHS — Stockholms Högskola

STI — Stockholms tekniska institut

Stim — Svenska tonsättares internationella musikbyrå, föreningen

StSI — Stockholms Socialinstitut

STTF — Svenska turisttrafikförbundet

StvT — Statsvetenskaplig Tidskrift

sv. — svensk, -a

SvD — Svenska Dagbladet

Sv:e — Sverige

Svenko — Svenska konfektionsfabrikantföreningen

SVF — sjövärnsflottilj

SvJT — Svensk Juristtidning

SVR — Sveriges högskolebildade väg- och vattenbyggares riksförbund

SvRK — Svenska Röda Korset

SvTF — Svenska teknologföreningen

SYL — Sveriges yngre läroverkslärares förening

SYLF — Sveriges yngre läkares förening

SYPF — Sveriges yngre prästers förening

<b>T</b>

T1 — Svea trängregemente

T2 — Göta trängregemente

T3 — Norrlands trängregemente

T4 — Skånska trängregementet

TBV — Tjänstemännens bildningsverksamhet

TCO — Tjänstemännens centralorganisation

TGO — Trafik ab Grängesberg—Oxelösund

TGOJ — Trafik ab Grängesberg—Oxelösunds järnvägar

Tibo — Träindustriens branschorganisation i Industriförbundet

TLL — Tekniska läroverkens lärarförbund

TNC — Tekniska nomenklaturcentralen

TSA — Tidskrift för Sveriges Advokatsamfund

TT — Tidningarnas telegrambyrå

TU — Svenska tidningsutgivareföreningen

TV — Television

<b>U</b>

UD — Utrikesdepartementet

UL — utländsk ledamot
