K4* — Smålands husarregemente, förutv.

K5* — Skånska  husarregementet, förutv.

K6* — Skånska dragonregementet, förutv.

K7* — Kronprinsens husarregemente, förutv.

KA1 — Vaxholms kustartilleriregemente

KA2 — Karlskrona kustartilleriregemente

KA3 — Gotlands kustartillerikår

KA4 — Älvsborgs kustartilleriregemente

KA5 — Härnösands kustartillerikår

KAK — Kgl.  Automobilklubben

KB — Kungliga Biblioteket

KeLiFa — Kemisk-tekniska och livsmedelsfabrikanters förening

KF — Kooperativa förbundet

KHS — Krigshögskolan

KKH —- Kgl. Konsthögskolan

KLH — Kgl. Lantbrukshögskolan

KLSR — Kvinnliga legitimerade sjukgymnasters riksförbund

KMO — Kungl. Maj:ts Orden

korrL — korresponderande ledamot

KRO — Konstnärernas riksorganisation

KrVA — Krigsvetenskapsakademien

KS — Krigsskolan

KSAK — Kgl. Svenska Aeroklubben

KSHS — Kgl. Sjökrigshögskolan

KSS — Kgl. Sjökrigsskolan

KSSS — Kgl. Svenska Segelsällskapet

KTH — Kgl. Tekniska Högskolan

<b>L</b>

L — ledamot

LA — Lantbruksakademien, numera Skogs- och Lantbruksakademien

LBF — Lantbruksförbundets byggnadsförening

LHS — Humanistiska vetenskapssamfundet i Lund

Litt. et Art. — Litteris et Artibus

LKAB — Luossavaara-Kiirunavaara ab

LME — Telefon ab L. M. Ericsson

LO — Landsorganisationen

LSI — Lunds Socialinstitut

lst — landstormen

LT — Lantbruksförbundets tidskriftsab

LTK  — Lantbruksförbundets tidskriftsaktiebolags korrespondensinstitut

lv — luftvärn

Lv1 — Karlsborgs luftvärnsregemente

Lv2 — Östgöta luftvärnsregemente

Lv3 — Stockholms luftvärnsregemente

Lv4 — Skånskaluftvärnskåren

Lv5 — Sundsvalls luftvärnskår

Lv6 — Göteborgs luftvärnskår

Lv7 — Luleå luftvärnskår

LvSS — Luftvärnsskjutskolan

<b>M</b>

M — Motormännens riksförbund

MA — Musikaliska akademien

M. A. — Master of Arts

MAB — Manufakturaktiebolaget i Malmö

MBA — Master of Business Administration

MHF — Motorförarnas Helnykterhetsförbund

milbef. — militärbefälhavare

milbefstab — militärbefälsstab

milo — militärområde

MO — Militieombudsman

M. Sc. — Master of Science

MT — Morgon-Tidningen

MYA — Malmö Yllefabriksaktiebolag

<b>N</b>

NAF — ab Nordiska Armaturfabrikerna

NBC — Nordens bondeorganisationers centralråd

nd, ndr — nämnd, -er

NFK — Nordiskt förbund för
kvinnogymnastik

NGU — Nordisk grafikunion

NJA — Nytt juridiskt arkiv

NK — ab Nordiska Kompaniet

NM — nordiskt mästerskap

NSS — Nathan Söderblomsällskapet

NTF — Nationalföreningen för trafiksäkerhetens främjande

NVA — Norske videnskaps-akademi i Oslo
