Statstjänstemännens riksförbund — SR
Statsvetenskaplig Tidskrift — StvT
Stockholms Allmänna Lawntennis-klubb — SALK
Stockholms Högskola — StHS
Stockholms luftvärnsregemente — Lv 3
Stockholms Socialinstitut — StSI
Stockholms tekniska institut — STI
Stockholms-Tidningen — ST
Sundsvalls luftvärnskår — Lv 5
Svea artilleriregemente — A 1
Svea flygflottilj — F 8
Svea ingenjörkår — Ing 1
Svea livgarde — I 1
Svea trängregemente — T 1
Svensk filmindustri — SF
Svensk Interkontinental Lufttrafik ab — SILA
Svensk Juristtidning — SvJT
Svenska ab Gasaccumulator — AGA
Svenska Aeroplan AB — SAAB
Svenska akademiens ordbok — SAO
Svenska Amerika Linien — SAL
Svenska arbetsgivareföreningen — SAF
Svenska arbetsgruppen för världsfederation — SAV
Svenska arkitekters riksförbund — SAR
Svenska byggnadsentreprenörföreningen — SBEF
Svenska byggnadsindustriförbundet — SBIF
Svenska centralkommittén för internationella ingenjörskongresser — SCII
Svenska Dagbladet — SvD
Svenska elektriska kommissionen — SEK
Svenska elektriska materielkontrollanstalten — SEMKO
Svenska elektroingenjörsföreningen —  SEIF
Svenska entreprenadab — Sentab 
Svenska industritjänstemannaförbundet — SIF
Svenska journalistförbundet — SJF
Svenska konfektionsfabrikantföreningen — Svenko
Svenska konsulterande ingenjörers förening — SKIF
ab Svenska Kullagerfabriken — SKF
Svenska landsbygdens studieförbund —  SLS
Svenska lantmännens riksförbund —  SLR
Svenska missionsförbundet — SMF
Svenska Personal-Pensionskassan — SPP
Svenska prästförbundet — SPF
Svenska Röda Korset — SvRK
Svenska slöjdföreningen — SSF
Svenska Sockerfabriks-ab — SSA
Svenska teknologföreningen — SvTF
Svenska tidningsutgivareföreningen — TU
Svenska turbinfabriks ab Ljungström — STAL
Svenska turistföreningen — STF
Svenska turisttrafikförbundet — STTF
Svenska tändsticksaktiebolaget — STAB
Sveriges advokatsamfund — SA
Sveriges akademikers centralorganisation — Saco
Sveriges arbetares centralorganisation — SAC
Sveriges förenade studentkårer — SFS
Sveriges geologiska undersökning — SGU
Sveriges hantverks- och småindustriorganisation — SHSO
Sveriges högskolebildade väg- och vattenbyggares riksförbund — SVR
Sveriges högskoleutbildade elektriska ingenjörers riksförbund — SER
Sveriges kommunalanställdas pensionskassa — SKP
Sveriges litografiska tryckerier, ab — SLT
Sveriges läkareförbund — SLF
Sveriges lärares nykterhetsförbund —  SLN
Sveriges maskinindustriförenings standardiseringskommitté — SMS
Sveriges nykterhetsvänners landsförbund — SNLF
Sveriges socialdemokratiska ungdomsförbund — SSU
Sveriges standardiseringskommission — SIS 
