Härnösands kustartillerikår — KA 5

högern — h

Högre konstindustriella skolan — HKS

Högsta domstolen — HD

<b>I</b>

Illis quorum meruere labores — Iqml

Industrikommissionen — IK

Infanteriskjutskolan — InfSS

Ingenjörsvetenskapsakademien — IVA

Inköpscentralernas ab — Ica

Inomeuropeisk mission — I. M.

inskrivningsområde — io

Institut International de Philosophie — IIP

Institute of Electrical Engineers — IEE

International Amateur Athletic Federation — IAAF

International Civil Aviation Organization — ICAO

International Council of Nurses — ICN

International Federation of Agricultural Producers — IFAP

International Labour Organization — ILO

International Material Conference — IMC

International Union of Pure and Applied Chemistry — IUPAC

<b>J</b>

Jernkontorets Annaler — JKA

Justitieombudsman — JO

Jämtlands flygflottilj — F 4

Jämtlands fältjägarregemente — I5

Jönköpings regemente, förutv. — I 12*

<b>K</b>

Kalmar flygflottilj — F 12

Kalmar regemente, förutv. — I 21*

Karlsborgs luftvärnsregemente — Lv 1

Karlskrona grenadjärregemente, förutv. — I 7*

Karlskrona kustartilleriregemente — KA 2

Kemisk-tekniska och livsmedelsfabrikanters förening — KeLiFa

Kgl. Automobilklubben — KAK

Kgl. Svenska Aeroklubben — KSAK

Kgl. Svenska Segelsällskapet — KSSS

kommunistiska partiet — k

Konsthögskolan — KKH

Konstnärernas riksorganisation — KRO

Kooperativa förbundet — KF

korresponderande ledamot — korrL

Krigsflygskolan — F 5

Krigshögskolan — KHS

Krigsskolan — KS

Krigsvetenskapsakademien — KrVA

Kronobergs regemente — I 11

Kronprinsens husarregemente, förutv. — K 7*

Kungl. Maj:ts Orden — KMO

Kungliga Biblioteket — KB

Kvinnliga legitimerade sjukgymnasters riksförbund — KLSR

<b>L</b>

Landsorganisationen — LO

landstormen — lst

Lantbruksakademien, numera Skogs-och Lantbruksakademien — LA

Lantbruksförbundets byggnadsförening — LBF

Lantbruksförbundets tidskriftsab — LT

Lantbruksförbundets tidskriftsaktiebolags korrespondensinstitut — LTK

Lantbrukshögskolan — KLH

ledamot — L

Litteris et Artibus — Litt. et Art.

Livgardesskvadronen — K 1

Livgardet till häst, förutv. — K 1*

Livgrenadjärregementet —  I 4

Livregementets grenadjärer — I 3

Livregementets husarer — K 3

luftvärn — lv

Luftvärnsskjutskolan — LvSS

Luleå luftvärnskår — Lv 7

Lunds Socialinstitut — LSI

Luossavaara-Kiirunavaara ab — LKAB

<b>M</b>

Malmö Yllefabriksaktiebolag — MYA

Manufakturaktiebolaget i Malmö — MAB

Master of Arts — M. A.

