<b>A</b>

Accademia Nazionale dei Lincei, Rom — ANdL

ab Aerotransport — ABA

Affärsekonomiska forskningsinstitutet — AEF

Aftonbladet — AB

Aftontidningen — AT

Akademien för de fria konsterna — FrKA

Alliance Internationale de Tourisme — AIT

Allmänna svenska elektriska aktiebolaget — Asea

Allmänna svenska prästföreningen — ASP

Andra flygeskadern — E 2

andra kammaren — AK

Andra livgrenadjärregementet, förutv. — I 5*

Arbetarnas bildningsförbund — ABF

Arbetsgivarnes ömsesidiga ansvarsförsäkringsbolag — AÖA

Arbetsgivarnes ömsesidiga olycksfallsförsäkringsbolag — AÖO

arbetsutskott — AU

Arméns underofficersskola — AUS

Arméstaben — ast

Artilleriskjutskolan — ArtSS

Artilleri- och Ingenjörhögskolan (högre kurs) — AIHS (hk)

Artilleri- och Ingenjörofficersskolan —  AIOS

Associé Musikaliska akademien — AssocMA

<b>B</b>

Bachelor of Arts — B. A.

Bachelor of Science — B. Sc.

Bergslagens artilleriregemente — A 9

Blekinge flygflottilj — F 17

Bodens artilleriregemente — A 8

Bodens ingenjörkår — Ing 3

Bohusläns regemente — I 17

bondeförbundet — bf

Bonniers Litterära Magasin — BLM

Bråvalla flygflottilj — F 13

Bränslekommissionen — BK

<b>C</b>

Centrala flygverkstaden, Västerås — CVV

Centrala värnpliktsbyrån — CVB

Centralförbundet för befälsutbildning — CFB

Centralförbundet för nykterhetsundervisning — CFN

Centralförbundet för socialt arbete — CSA

Chalmers Tekniska Högskola — CTH

Chalmers Tekniska Institut — CTI

Civila statsförvaltningens tjänstemannaförbund — CST

civilförsvarsområde — cfo

Compagnie d’Applications Mécaniques (SKF) — CAM

Conférence Internationale des Grands Réseaux Électriques — CIGRÉ

Congress of Industrial Organizations — CIO

<b>D</b>

Dagens Nyheter — DN

Dalregementet — I 13

Danske Videnskabernes Selskab Köpenhamn — DVS

De anställdas centralorganisation —  Daco

De kristliga samfundens nykterhetsrörelse — DKSN

Deutsches archäologisches Institut — DAI

Diplomerad från Handelshögskolan i Gbg — DHG

Diplomerad från Handelshögskolan i Sthlm — DHS

Diplomerad från Socialinstitut — DSI

Distriktsmästerskap — DM

Doctor of Science — D. Sc.

<b>E</b>

Economic Commission for Europé — ECE

Ekonomiska unionen mellan Storbritannien och de tre skandinaviska länderna — Uniscan

ekonomiskt utskott — EU

