H T	Harald Thorelli

Hub	Hubert Lärn

Hubertus	Hubert Lärn

Humpe	Gunilla Skawonius

Håkuté	Carl-Ewald Holmqvist

I B-n	Ingmar Bengtsson

I H	Ivar Hylander

-ius	Sven Frychius

Jacko	Gertrud Wieselgren

J B	Jean Braconier

Jigg	Pär-Arne Jigenius

Josef	Lars Stal in

Joy	Gerd Ribbing

Jung	se Beck och Jung

Kajenn	Caj Lundgren

Kaj Jans	Tore Wärenstam

Kar de Mumma	Erik Zetterström
Karl-Oskarsson,

Otto	Otto Carlsson
Katja of Sweden Katja Geiger

Kid	Ingrid Severin

Klippare, Petrus	Pelle Sollerman

K P	Knut Petersson
Krökén i Kröken,

J	Erik Brandt
Käringen mot

strömmen	Barbro Alving

Lagrup, Knut	Knut Hansson

Lalle	Gösta Leander

Lang, Maria	Dagmar Lange

Lennart	Lennart Strandberg

LGH	Lisa Genell-Harrie

Lindy	Karl Olof Hedström

-II-	Albrekt Ellsén

Loo, Anna	Marta
Sandwall-Berg-ström

Lovell-Svensson, Ann Margret Dahlquist-

Lotten	Ljungberg

-m-	Yngvar Alström
Malm, Margaretha Bertil Pettersson

Manson	Bror Hermansson

MaS	Margareta Sylwan

Méchant	Ernst Nathorst-Böös

Mix	Erik Gustaf Cavallin

M P	Moses Pergament

M Piéton	Torsten Måtte Schmidt

Mr Buss	Johan Sande

Mr Trend	Bertil Torekull

M S-g	Martin Strömberg

M T-G	Märta Tamm-Götlind

M v K-w	Margareta von Konow

N An	Nils Ahlgren

NB-nd	Nils Bokelund

Never Mind	Ivar Arnö

N Ewn	Nils Elowsson

N M	Nils Melander

N-n	Hjalmar Nilson

O J	Olof Jägerskiöld

0’Kay	Arne Lidström

O K-gh	Osvald Kragh

Oktav	Per-Anders Hellquist

Oleg	Olof Groth

XVIII

Ove	Ove Ekelund

P, P*, P-a, Px	Carl-Fredrik
Palm-stierna

Pal	Per Laurén

Palisander	Olle Norell

pekonen	Aili
Pekonen-Hen-schen

Pem	Åke Perlström

Pernilla	Pernilla Tunberger

Perpetua	Barbro Hähnel

P E W	Per Erik Wahlund

PGP	Per-Gustaf Peterson

Pia	Pia Hård af Segerstad

Pius	Set Poppius

Piv	Ivar Arnö

Pors, Eva	Harriet Hjorth

Portia	Synnove Bellander

Prudus	Fritz Hägg

Px	Kule Palmstierna

Pål	Stellan Rosén

QUI	Lisa Genell-Harrie

-qvist	Edvard Wallenqvist

-r	Jean Braconier

Red Top	Lennart Nyblom

Ret	Rudolf Eklöw

Rit-Ola	Jan-Erik Garland

-r -n	Gunnar Franzén

Robin Hood	Bengt
Idestam-Alm-quist

Roempke, Hilde Sussie Bjuvstedt

S	Sven Strömberg

Schr	Harald Schiller

S-e	Sigge Bergman

S-e	Sven Ulric Palme

S F	Sven Frychius

S-ff	Axel Olson

Sigge	Sigge Bergman

Sias	Stig Claesson

S Ln	Sigurd Lagerman

Sonsoff	Axel Olson

S R	Stellan Rosén

S R-n	Sven Rinman
Stenman, Karl-

Stefan	Björn Landström

Steve	Sven Strömberg

Stig L	Stig Lindberg

STh	Sture Thorsson

-str-	Yngvar Alström

SUP	Sven Ulric Palme

Svenne	Sven Strömberg

Svt	Svante Svärdström
Tecknar-Anders Anders Andersö

Tege	Märta Tamm-Götlind

Tekå	Torvald Karlbom

Tex	Tore Nilsson

T G W	Tord Wickbom

T G W	Tore Wärenstam

Th N	Thure Nyman

Tim	Tlmus Winqvist

T Km	Torvald Karlbom

T T	Torsten Tegnér

T W	Torsten Wilner