Pia	Pia Hård af Segerstad
Pinnemo, WG Gunnar Ljusterdal

Piv	Ivar Arnö

Px	Kule Palmstierna

Pål	Stellan Rosén

QUI	Lisa Genell-Harrie

-qvist	Edvard Wallenqvist

-r	Jean Braconier

Red Top	Lennart Nyblom

R:et	Rudolf Eklöw

Rit-Ola	Jan-Erik Garland

Robin Hood	Bengt Idestam-Almquist
Roempke, Hilde Sussie Bjuvstedt

S	Sven Strömberg

S-e	Sigge Bergman

S-ff	Axel Olson

Sigge	Sigge Bergman

Sias	Stig Claesson

Sonsoff	Axel Olson

S R-n	Sven Rinman

Stenman,	Karl-

Stefan	Björn Landström

19

Steve	Sven Strömberg
Stigson, Arne Arne Malmberg

Svenne	Sven Strömberg

Svt	Svante Svärdström
Tecknar-Anders Anders Andersö

Tege	Märta Tamm-Götlind

Tex	Tore Nilsson

T G W	Tord Wickbom

Tosca	Ingrid Schöier

Wachen	Bertil von Wachenfeldt

W B	Walter Bauer

Veits, Ulf	K Sivert Lindberg
Werner,

Thomas B	Arne Blom

Viktor Viktor	Elsa Maria Otto

Viola	Marianne Zetterström

W N	Wilhelm Norlind

Å V S	Åke V Ströni.

Ö-n	Carl Johan Östman