SJFR	Skogs- och jordbrukets

forskningsråd

SjöV	Sjöfartsverket

SK	Statens konstråd

SKAFAB Stockholms kommuns	Avfalls-

förädling AB

Skap Svenska kompositörer av
populärmusik, föreningen

SKBR	Sveriges Kvinnliga Bilkårers

Riksförbund

SKFP	Svenska kyrkans församlings-

och pastoratsförbund

SKG	Sveriges kristliga gymnasist-

rörelse

SkHS	Skogshögskolan

SKI	Statens kärnkraftinspektion

SKIF	Svenska Konsulterande

Ingenjörers Förening

SKL	Statens kriminaltekniska

laboratorium

SKM	Statens konstmuseer

SKP	Sveriges Kommunalanställdas

Pensionskassa

SKP	Sveriges Kommunistiska Parti

SKR	Sveriges Konstföreningars

Riksförbund

SkS	Samfundet för utgivande av

handskrifter rörande
Skandinaviens historia

SKS	Sveriges Kyrkliga Studieförbund

SKSF	Sveriges kristna social-

demokraters förbund

SKTF	Sveriges Kommunaltjänste-

mannaförbund

SKUAB	Svenska kyrkans utbildnings AB

SKUC	Svenska Kyrkans Utbildnings-

centrum

SKUT Stiftelsen för kyrkan i utlandet

SL	AB Storstockholms Lokaltrafik

SLAB	Svenska lastbil AB

SLF	Sveriges Läkarförbund

SLR	Svenska Lantmännens Riks-

förbund

SLS Svenska Landsbygdens
Studieförbund

SLS	Svenska läkaresällskapet

SLSF	Svenska litteratursällskapet i

Finland

SLT	AB Sveriges Litografiska

Tryckerier, numera Esselte AB

SLU	Svenska Landsbygdens

Ungdomsförbund

SLU	Sveriges Lantbruksuniversitet

SLV	Statens livsmedelsverk

SM	svenskt mästerskap

SME Society of Manufacturing
Engineers

SMF	Svenska	Missionsförbundet

SMHI	Sveriges	Meteorologiska och

Hydrologiska Institut

SMI	Sveriges	Militära Idrottsförbund

SMP	Ordbok	över Sveriges medeltida

personnamn

SMP	Stormarknadspress

SMR	Svenska Mekanikers Riks-

förening

SMS	Sveriges Mekanstandardisering

SMU	Svenska Missionsförbundets

Ungdom

SMVK	Statens Museer för Världskultur

SNAU	Statens nämnd för Arbetstagares

uppfinningar

SNF	Svenska naturskyddsföreningen

SNS	Studieförbundet Näringsliv och

Samhälle

SNV	Statens naturvårdsverk

SOK	Sveriges olympiska kommitté

SOM-institutet Samhälle, Opinion,
Massmedia-institutet

SoS	Socialstyrelsen

SOU	statens offentliga utredningar

SP	Sveriges provnings- och

forskningsinstitut

SPA	Sveriges Praktiserande Arkitekter

Spadab	Sparbankernas Datacentraler AB

SPF	Sveriges pensionärsförbund

SPK	Statens Pris- och Konkurrensverk

SPP	Svenska Personal-Pensionskassan

SPPB	Statens psykologisk-pedagogiska

bibliotek

Spri	Sjukvårdens och socialvårdens

planerings- och
rationaliseringsinstitut

SPS	Scandinavian Political Studies

SPV	Statens löne- och pensionsverk

SR	Sveriges Radio

SRF	Sveriges Rationaliseringsförbund

SRF	Sveriges Redovisningskonsulters

Förbund

SRF	Synskadades riksförbund

SRK	Svenska Röda Korset

SRV	Statens Räddningsverk

SS	Skytteanska samfundet

SSAB	Svenskt Stål AB

SSA-råd	lokalt planeringsråd för

samverkan skola-arbetsliv

SSF	Svenska Slöjdföreningen

SSHM	Statens sjöhistoriska museum

SSI	Statens strålskyddsinstitut

SSI	Svenska samfundet för

18