Factu	Föreningen Svensk Fackpress

FAO	Food and Agriculture Organi-

zation of the United Nations

FAO	Försäkringsbranschens arbets-

givareorganisation

FAR	Föreningen Auktoriserade

Revisorer

FArådet Rådet för företagsledning	och

arbetslivsfrågor

FBU	Frivillig Befälsutbildning

FCF	Försvarets civilförvaltning

FDI	Fédération Dentaire

Internationale

Fera	Föreningen för elektricitetens

rationella användning

ff	och följande

FFA	Flygtekniska försöksanstalten

FFI	Företagsekonomiska Forsknings-

institutet vid Handelshögskolan
i Stockholm

FFV	Förenade Fabriksverken

FGS	Företagsgrupperna i Stor-

stockholm

FHK	Folkhushållningskommissionen

FHR	Folkets Hus-föreningarnas Riks-

organisation

FHS	Försvarshögskolan

Fl	Försäkringsinspektionen

FIATA	Fédération Internationale des

Associations de Transitaires et
Assimilés

Fib	Folket i Bild

FIDIC	Fédération Internationale des

Ingénieurs-Conseils Lausanne

FIEF	Fackföreningsrörelsens institut

för ekonomisk forskning

FiForstS	Finska forstsamfundet

FIP	Fédération Internationale de la

Précontrainte

FIRT	Fédération Internationale pour la

Recherche Théåtrale

FiVA	Finska Vetenskapsakademien

FJS	Arméns fallskärms jägarskola

FK	första kammaren

FKHS	Flygkrigshögskolan, förutv, Flyg-

vapnets krigshögskola

Fl	flottan

fik	fältläkarkåren, förutv

FLT	Förenade Landsortstidningar

flybo	flygbasområde

FLYCO Fria Litterära Yrkesutövarnas
Centralorganisation

FMHS	Försvarsmaktens

Halmstadsskolor

FMV	Försvarets Materielverk

fo	försvarsområde

FOA	Försvarets Forskningsanstalt

fobef	försvarsområdesbefälhavare

FoM	Förlags- och Mediaförbundet,

FortF	Fortifikationsförvaltningen

FortV	Fortifikationsverket

FOS	Frivilligorganisationerns sam-

arbetskommitté

FoU	Forskning och Utveckling

fp	Folkpartiet liberalerna

FPG	Försäkringsbolaget Pensions-

garanti

FPK Försäkringsbranschens
pensionskassa

FPU Folkpartiets ungdomsförbund
FRCP Fellow of the Royal College of
Physicians

FRCPCH Founder fellow Royal College
Pediatrics of Child Health

FRCPED Fellow of the Royal College of
Physicians of Edinburgh

FRCS	Fellow of the Royal College of

Surgeons

FRI	Försvarets rationaliseringsinstitut

FrKA	Akademien för De Fria

Konsterna

FRN	Forskningsrådsnämnden

FRS	Försäkringsrätten södra Sverige

FRSA	Fellow Royal Society of Arts

FS	Fysiografiska Sällskapet i Lund

FSF	Svenska Flygsportförbundet

FSM	Föreningen Svenska Marknads-

undersökningsinstitutet

FSMK	Föreningen för Sveriges Medie-

och kommunikationsforskning

FSPA	Föreningssparbanken

FST	Föreningen Svenska Tonsättare

fst	försvarsstaben

FU	förvaltningsutskott

FUB	Riksförbundet för Utvecklings-

störda Barn, Ungdomar och
Vuxna

FV	flygvapnet

fvk	fältveterinärkåren, förutv

FVS	Finska Vetenskapssocieteten

FörvS	Försvarets förvaltningsskola

Fövux	Kommittén för försöksverk-

samhet med vuxenutbildning

GAA	Gustav Adolfs Akademien

GATT	General Agreement on Tariffs

and Trade

GbgHdll	Göteborgs Handelsinstitut

GbgHS	Göteborgs Högskola

GbgSI	Socialinstitutet i Göteborg

Gesamp	Joint group of experts on

io