Signaturer och pseudonymer

Anders	Anders Andersö

Anea	Anna Lena Wik-

Thorsell

Ax Sbg	Axel Strindberg

Beck och Jung	Holger Bäckström

och Bo Ljungberg

Bey	Ulla Beyron-

Henriques

B Hbs	Bengt Hambræus

Carl Z	Carl Zetterström

Clem	Kaj Karlholm

Cussion, Per	Per Tjernberg

Derrick	Dietrich Winter

Doktor

Gormander	Gunnar Ohrlander

D M W	Dietrich Winter

Ekblom, Pål A	K Arne Blom

EWA	Erik Albertson

EWK	Ewert Karlsson

FHT	Folke H Törnblom

Gem	Gösta Edström

G H-n	Gunnar Helén

GLOBO	Ulf Mörling

Gormander	Gunnar Ohrlander

Gulle	Gunilla Brorsson

Wolde

Hedlund,

Jan- Olof	Sun Axelsson

Herr Talman	Gunnar Ljusterdal

Hiram	Märit Huldt

H J	Harry Järv

HJv	Harry Järv

Hubert,

Tord	Tord Hubert

Lindström

Jacko	Gertrud Wieselgren

Jigg	Pär-Arne Jigenius

Jung	se Beck och Jung

Karl-Oskarsson,
Otto	Otto Carlsson

Klippare, Petrus	Pelle Sollerman

Lagevi, Bo	K Arne Blom

Lazy	Bengt Lindroos

LGH	Lisa Genell-Harrie

Lovell-Svensson,	Ann Margret

Lotten	Dahlquist-Ljungberg

Malm,
Margaretha	Bertil Pettersson

MaS	Margareta Sylwan

Mr Trend	Bertil Torekull

Nordstedt F J	Christian Braw

Notarien	Gunnar Ljusterdal

Oktav	Per-Anders Hellqvist

Palisander	Olle Norell

Pia	Pia Hård af Segerstad

Pinnemo, W G	Gunnar Ljusterdal

QUI	Lisa Genell-Harrie

S-e, Sigge	Sigge Bergman

Sias	Stig Claesson

Stenman,
Karl-Stefan	Björn Landström

Stigson, Ame	Arne Malmberg

Tecknar-Anders	Anders Andersö

T G W	Tord Wickbom

Tosca	Ingrid Schöier

Veits, Ulf	K Sivert Lindberg

Werner,

Thomas B	K Arne Blom

Viktor Viktor	Elsa Maria Otto

Winter, Harry	Bo Hugemark och

Ingemar Dörfer

Viola	Marianne

Zetterström

21